%%%%%%%
%%% G %
%.  % %
%P%%% %
% . . %
%%%%%%%
