%%%%%%%
%.    %
%  %G %
%P%%% %
% . . %
%%%%%%%
