%%%%%%%
%%%  P%
%   %.%
%G% % %
%%%%%%%
