%%%%%%%
% .   %
%   G %
% P   %
%   . %
%%%%%%%
