%%%%%%%
%%%...%
%..G%.%
%P%%% %
% .  .%
%%%%%%%
