%%%%%
% . %
%  G%
%  P%
%%%%%
