%%%%%%%
% % . %
%   %G%
%P% %%%
% .   %
%%%%%%%
