%%%%%%%%%%%%%%%%%%%%
% ...%........%... %
%.%%.%.%%..%%.%.%%.%
%.%.....%..%.....%.%
%.%.%%.%%  %%.%%.%.%
%......  G  %.%....%
%.%....%%%%%%.%..%.%
%.%....%    %.%..%.%
%.%....% %%%%.%..%.%
%.%...........%..%.%
%.%%.%.%%%%%%.%.%%.%
% ...%...P....%... %
%%%%%%%%%%%%%%%%%%%%
